Rank,Player,Cl,Ht,Pos,S,Block Solos,Block Assists,Total,Per Set
1,"Nicodemus Meyer, Loyola Chicago (MIVA)",Sr.,6-10,MB,85,19,91,110,1.294
2,"Relja Milosavljevic, Quincy (MIVA)",So.,6-6,MB,87,34,72,106,1.218
3,"David Weiss, St. Thomas Aquinas (ECC)",So.,6-7,MB,74,14,76,90,1.216
4,"Ryan Uridel, Barry (DI Independent)",Fr.,6-5,MH,80,6,89,95,1.188
5,"Stilian Delibosov, CSUN (Big West)",Fr.,6-6,MB,82,12,84,96,1.171
6,"Ryan Geraci, Barton (Conference Carolinas)",So.,6-6,MB,86,24,76,100,1.163
7,"Tyler Kuehl, Erskine (Conference Carolinas)",So.,6-5,MB,53,9,52,61,1.151
8,"Parker Tomkinson, Southern California (MPSF)",Fr.,7-0,MB,73,5,78,83,1.137
9,"Jibriel Elhaddad, Belmont Abbey (Conference Carolinas)",Jr.,6-7,MB,74,19,64,83,1.122
10,"Isaac Benka, LIU (NEC)",So.,6-9,MB,67,8,67,75,1.119
11,"Matthew Gentry, Lincoln Memorial (DI Independent)",Sr.,6-7,MB,70,21,57,78,1.114
12,"Cameron Thorne, UCLA (MPSF)",So.,6-4,MB,72,10,70,80,1.111
13,"Niko Hales, BYU (MPSF)",Fr.,6-8,MB,70,11,65,76,1.086
14,"Holden Maryott, Mount Olive (Conference Carolinas)",Sr.,6-7,MB,63,10,57,67,1.063
15,"Alexander Lillie, George Mason (EIVA)",Fr.,6-8,MB,72,31,45,76,1.056
15,"Teon Taylor, BYU (MPSF)",Sr.,6-6,OH,90,15,80,95,1.056
17,"Guy Genis, Southern California (MPSF)",Sr.,6-5,MB,62,4,61,65,1.048
18,"Clement Osahon Jr., CUI (MPSF)",Sr.,6-5,MB,65,14,54,68,1.046
19,"Owen Rose, Penn St. (EIVA)",Sr.,6-7,MB,75,11,67,78,1.040
20,"Kurt Nusterer, Hawaii (Big West)",Jr.,6-9,MB,79,9,72,81,1.025
21,"DiAeris McRaven, Long Beach St. (Big West)",Sr.,6-5,MB,65,5,61,66,1.015
22,"Trevell Jordan, Grand Canyon (MPSF)",Fr.,6-10,MB,66,12,55,67,1.015
23,"Micah Goss, UC Irvine (Big West)",Fr.,6-6,MB,71,9,62,71,1.000
24,"Rolen Lively, McKendree (MIVA)",Jr.,6-8,MB,94,15,77,92,0.979
25,"Elias Fuhrer, Barry (DI Independent)",Fr.,6-8,MH,84,7,75,82,0.976
26,"Vanis Buckholz, Ball St. (MIVA)",Sr.,6-6,MB,83,8,73,81,0.976
27,"Micah Sybesma, Vanguard  (MPSF)",So.,6-7,MB,85,12,70,82,0.965
28,"Tristan Whitfield, Princeton (EIVA)",So.,6-7,MB,56,8,46,54,0.964
29,"James Eadie, Pepperdine (MPSF)",So.,6-7,MB,74,10,61,71,0.959
30,"Eliel Salva Torres, Lincoln Memorial (DI Independent)",So.,6-5,MB,66,10,53,63,0.955
31,"Nathan Vaupel, Queens (NC) (MIVA)",Jr.,6-6,MH,87,20,63,83,0.954
32,"Brian Thomas, Harvard (EIVA)",Jr.,7-0,MB,50,10,37,47,0.940
33,"Aaron Johnson, Sacred Heart (EIVA)",Fr.,6-5,MB,56,8,44,52,0.929
34,"Kevin Doran, Maryville (MO) (DI Independent)",Sr.,6-8,MB,57,10,42,52,0.912
35,"Maverick O'Neil, Daemen (NEC)",Sr.,6-3,MH,66,16,44,60,0.909
36,"Alain Tamo-Noche, Central St. (OH) (SIAC)",Sr.,6-1,OH,61,6,49,55,0.902
37,"Morgan Makovec, Tusculum (DI Independent)",So.,6-5,MB,90,19,62,81,0.900
38,"Tyler Johnwick, Missouri S&T (DI Independent)",So.,6-8,MB,75,18,49,67,0.893
39,"Tymek Brzoza, D'Youville (NEC)",Sr.,6-5,MB,65,12,46,58,0.892
40,"Caleb Lipscomb, Purdue Fort Wayne (MIVA)",Sr.,6-11,MB,71,15,48,63,0.887
41,"D'Aaron McCraney, McKendree (MIVA)",Sr.,6-8,MB,97,12,74,86,0.887
42,"Ryan Vena, Princeton (EIVA)",Jr.,6-7,MB,67,9,50,59,0.881
43,"Maxim Grigoriev, UC Irvine (Big West)",Jr.,6-4,MB,74,12,53,65,0.878
44,"Ephraim Abhulime, Merrimack (DI Independent)",Fr.,6-7,MB,57,5,45,50,0.877
45,"Andrew Fedmasu, NJIT (EIVA)",Jr.,6-5,MB,80,12,58,70,0.875
45,"Kolden Okin, Kentucky St. (SIAC)",Sr.,6-2,OPP,16,9,5,14,0.875
47,"Braeden Goebbert, NJIT (EIVA)",Jr.,6-7,MB,79,12,57,69,0.873
48,"Braydon Savitski-Lynde, Ball St. (MIVA)",So.,6-7,MB,94,9,73,82,0.872
49,"Omarion Pierce, Thomas More (DI Independent)",So.,6-7,MB,52,16,29,45,0.865
50,"Wyatt Eastin, Catawba (DI Independent)",Fr.,6-5,MB,72,9,53,62,0.861
51,"Ben Wiechert, Barton (Conference Carolinas)",Sr.,6-6,MB,84,18,54,72,0.857
52,"Jackson Lahey, Mount Olive (Conference Carolinas)",Jr.,6-2,S,68,8,50,58,0.853
52,"Gabriel Vieira, St. Thomas Aquinas (ECC)",So.,6-9,OH,68,9,49,58,0.853
54,"Nolan Flexen, UC Irvine (Big West)",Jr.,6-9,OH,74,4,59,63,0.851
55,"Brad Bell, Loyola Chicago (MIVA)",Jr.,6-9,MB,60,6,45,51,0.850
56,"Deâ€™Andrae Taylor, Benedict (SIAC)",Sr.,6-3,MB,65,26,29,55,0.846
57,"Garrett Hockman, Belmont Abbey (Conference Carolinas)",So.,6-5,MB,58,9,40,49,0.845
58,"Jacob Schurfranz, Thomas More (DI Independent)",So.,6-8,MB,63,17,36,53,0.841
59,"Gaige Gabriel, Penn St. (EIVA)",Fr.,6-8,MB,75,9,54,63,0.840
60,"Daniel Malcolm, Dominican (NY) (ECC)",Fr.,6-5,MB,73,14,47,61,0.836
61,"Connell Kane, Menlo (MPSF)",Sr.,6-5,OPP,54,7,38,45,0.833
62,"Casey Lyons, Purdue Fort Wayne (MIVA)",So.,6-7,OPP,86,15,56,71,0.826
63,"Ken Naples, Sacred Heart (EIVA)",Sr.,6-7,MB,57,9,38,47,0.825
64,"Caleb Rohlwing, Missouri S&T (DI Independent)",Jr.,6-7,MB,65,14,39,53,0.815
65,"Taviian Martin, Fort Valley St. (SIAC)",Jr.,6-9,MB,53,6,37,43,0.811
66,"Nyherowo Omene, Princeton (EIVA)",Sr.,6-7,OH,69,8,47,55,0.797
67,"Moses Wagner, Stanford (MPSF)",Jr.,6-6,OPP,73,6,52,58,0.795
68,"Owen Birg, UC Santa Barbara (Big West)",Jr.,6-8,OH,82,4,61,65,0.793
69,"Cole Duncanson, Grand Canyon (MPSF)",Sr.,6-9,MB,84,6,60,66,0.786
70,"Moni Nikolov, Long Beach St. (Big West)",Fr.,6-8,S,78,5,56,61,0.782
71,"Daniil Hershtynovich, Long Beach St. (Big West)",So.,6-9,OPP,68,4,49,53,0.779
72,"Ethan Watson, Pepperdine (MPSF)",So.,6-8,MB,72,4,52,56,0.778
73,"Reed Shuey, Queens (NC) (MIVA)",Jr.,6-6,MH,97,14,61,75,0.773
74,"Donovan Constable, CSUN (Big West)",Sr.,6-2,S,88,9,58,67,0.761
75,"Skyler Varga, Long Beach St. (Big West)",Sr.,6-7,OH,67,4,47,51,0.761
76,"Sterling Foley, Southern California (MPSF)",Fr.,6-6,OH,77,6,52,58,0.753
77,"Tommaso Falchi, Dominican (NY) (ECC)",So.,6-5,MB,80,11,49,60,0.750
77,"Owen Woolbert, Harvard (EIVA)",So.,6-6,MB,60,7,38,45,0.750
79,"Shayo Asiru, Erskine (Conference Carolinas)",Sr.,6-3,MB,54,7,33,40,0.741
80,"Constantinos Iacovou, Mount Olive (Conference Carolinas)",Jr.,6-6,MB,64,7,40,47,0.734
81,"Owen Fanning, Harvard (EIVA)",Sr.,6-7,OH,56,8,33,41,0.732
82,"Zach Puentes, Belmont Abbey (Conference Carolinas)",So.,6-2,OH,67,10,39,49,0.731
83,"Luke O'Neill, Catawba (DI Independent)",Sr.,6-5,MB,52,7,31,38,0.731
84,"Jack Sandahl, Barton (Conference Carolinas)",Sr.,6-3,OH,74,8,46,54,0.730
85,"Frederick Krueger-Beer, Lewis (MIVA)",Fr.,6-8,MH,92,6,61,67,0.728
85,"Aleksandar Sosa, Quincy (MIVA)",So.,6-7,OPP,92,13,54,67,0.728
87,"Sebastian Heer, Lees-McRae (Conference Carolinas)",Sr.,6-3,MB,88,17,47,64,0.727
88,"Matthew Luoma, Penn St. (EIVA)",So.,6-7,OH,62,4,41,45,0.726
89,"Simon Falayi, Central St. (OH) (SIAC)",So.,6-5,MB,76,15,40,55,0.724
90,"Colton Beres, Barry (DI Independent)",Fr.,6-5,OH,65,4,43,47,0.723
90,"Sean Haberthy, King (TN) (Conference Carolinas)",Sr.,6-6,MB,65,12,35,47,0.723
92,"Kaumana Carreira, Stanford (MPSF)",Fr.,6-8,MB,54,2,37,39,0.722
93,"Nick Tidik, Merrimack (DI Independent)",Jr.,6-6,MB,61,2,42,44,0.721
94,"Panagiotis Kourmouzos, FDU (NEC)",Jr.,6-2,MB,57,5,36,41,0.719
94,"William Phinizy, Barry (DI Independent)",So.,6-6,OH,57,1,40,41,0.719
96,"Joseph Morris, Belmont Abbey (Conference Carolinas)",So.,6-6,S,71,9,42,51,0.718
97,"Hakan Godoy, Benedict (SIAC)",So.,6-2,MB,66,21,26,47,0.712
98,"Tread Rosenthal, Hawaii (Big West)",So.,6-8,S,86,4,57,61,0.709
99,"Grayson Stoudt, King (TN) (Conference Carolinas)",Sr.,6-4,MB,85,7,53,60,0.706
100,"Sam Lane, Saint Francis (NEC)",Jr.,6-6,MB,70,3,46,49,0.700
